5 5 5 5 5 5 5 5 5 5 5 5 5 5 5 5 5 5 5 5 5 5 5 5 5 22 23 23 23 23 23 23 23 23 23 23 23 23 23 23 23 23 23 23 23 23 23 23 23 24
5 22 23 23 23 24 4 4 4 14 15 15 15 15 15 15 15 15 15 15 15 15 15 16 5 25 0 0 0 0 0 0 0 0 0 0 0 0 0 0 0 0 0 0 0 0 0 0 0 26
5 25 0 28 28 29 14 15 15 20 20 20 20 20 20 20 20 20 20 1 1 1 20 21 5 25 0 0 0 0 0 0 0 0 0 0 0 0 0 0 0 0 0 0 0 0 0 0 0 26
5 27 29 14 15 15 1 1 18 4 4 5 5 5 5 5 5 5 5 17 1 18 5 5 5 25 0 0 0 0 0 0 0 0 0 0 0 0 0 0 0 0 0 0 0 0 0 0 0 26
5 4 14 1 20 20 20 20 21 4 4 5 5 5 5 5 5 5 14 1 1 21 5 5 5 25 0 0 0 0 0 0 0 0 0 0 0 0 0 0 0 0 0 0 0 0 0 0 0 26
5 4 17 18 4 4 4 4 4 4 5 5 5 5 5 14 15 15 20 20 21 5 22 24 5 25 0 0 0 0 14 15 15 15 15 15 15 15 15 15 15 15 15 16 0 0 0 0 0 26
5 4 17 18 4 4 4 4 4 5 5 1 1 1 15 1 1 21 4 4 5 22 0 29 5 25 0 0 0 0 17 1 1 1 1 1 1 1 1 1 1 1 1 18 0 0 0 0 0 26
5 4 17 18 4 4 5 5 5 1 1 2 2 2 1 1 18 4 4 4 5 27 29 5 5 25 0 0 0 0 17 1 1 20 20 20 20 20 20 20 20 1 1 18 0 0 0 0 0 26
5 4 17 18 5 5 5 5 1 2 2 2 4 2 2 2 1 4 4 5 5 5 5 5 5 25 0 0 0 0 17 1 18 48 43 50 46 51 44 49 42 17 1 18 0 0 0 0 0 26
5 4 17 18 5 5 4 1 2 2 4 4 4 4 4 2 2 1 4 5 5 5 5 5 5 25 0 0 0 0 17 1 18 41 47 41 47 41 47 41 47 17 1 18 0 0 0 0 0 26
5 4 17 18 5 4 4 1 2 4 4 4 4 4 4 4 2 1 5 5 5 5 5 5 5 25 0 0 0 0 17 1 18 31 30 31 30 31 30 31 30 17 1 18 0 0 0 0 0 26
5 4 17 18 5 4 1 2 2 4 4 4 4 4 4 4 2 2 1 5 5 5 5 4 5 14 15 15 15 15 1 1 18 30 31 30 31 30 31 30 31 17 1 18 0 0 0 0 0 26
5 4 17 18 5 4 1 2 4 4 4 4 1 4 4 4 4 2 1 5 5 5 14 15 1 1 1 1 1 1 1 1 18 31 30 31 30 31 30 31 30 17 1 18 0 0 0 0 0 26
5 5 17 18 5 4 1 2 2 4 4 4 4 4 4 4 2 2 1 4 5 14 1 18 5 19 20 20 20 20 1 1 18 30 31 30 31 30 31 30 31 17 1 18 0 0 0 0 0 26
5 5 17 18 5 4 4 1 2 4 4 4 4 4 4 4 2 1 4 4 5 17 1 18 5 25 0 0 0 0 17 1 18 39 40 39 40 39 40 39 40 17 1 18 0 0 0 0 0 26
5 5 17 18 5 4 4 1 2 2 4 4 4 4 4 2 2 1 4 5 5 17 1 21 5 25 0 0 0 0 17 1 18 32 38 34 35 36 39 33 37 17 1 18 0 0 0 0 0 26
5 5 17 18 5 4 4 4 1 2 2 2 4 2 2 2 1 4 4 5 5 17 21 5 5 25 0 0 0 0 17 1 1 15 15 15 15 15 15 15 15 1 1 18 0 0 0 0 0 26
5 5 17 18 5 5 5 4 4 1 1 2 2 2 1 1 4 4 5 5 14 18 5 5 5 25 0 0 0 0 17 1 1 1 1 1 1 1 1 1 1 1 1 18 0 0 0 0 0 26
5 4 17 18 4 4 5 5 4 4 4 1 1 1 4 4 4 5 5 5 17 18 5 5 5 25 0 0 0 0 19 20 20 20 20 20 20 20 20 20 20 20 20 21 0 0 0 0 0 26
5 5 19 1 16 4 4 5 5 5 5 5 5 5 5 5 5 5 5 14 1 21 5 5 5 25 0 0 0 0 0 0 0 0 0 0 0 0 0 0 0 0 0 0 0 0 0 0 0 26
5 5 5 19 1 16 4 4 4 4 4 4 4 5 5 5 5 5 14 1 21 5 5 5 5 25 0 0 0 0 0 0 0 0 0 0 0 0 0 0 0 0 0 0 0 0 0 0 0 26
5 5 5 5 19 1 15 15 15 15 15 15 15 15 15 15 15 15 1 18 5 5 5 5 5 25 0 0 0 0 0 0 0 0 0 0 0 0 0 0 0 0 0 0 0 0 0 0 0 26
5 5 5 5 5 19 20 20 20 20 20 1 1 1 20 20 20 20 20 21 5 5 5 5 5 25 0 0 0 0 0 0 0 0 0 0 0 0 0 0 0 0 0 0 0 0 0 0 0 26
3 3 3 3 3 3 3 3 3 4 4 19 1 21 4 3 3 3 3 3 3 3 3 3 3 25 0 0 0 0 0 0 0 0 0 0 0 0 0 0 0 0 0 0 0 0 0 0 0 26
3 3 3 3 3 3 3 3 3 3 3 3 1 3 3 3 3 3 3 3 3 3 3 3 3 27 28 28 28 28 28 28 28 28 28 28 28 28 28 28 28 28 28 28 28 28 28 28 28 29
6 6 6 10 9 6 6 6 6 6 6 6 6 6 58 57 61 6 6 54 53 8 6 6 6 6 6 6 6 6 6 6 6 6 6 6 6 6 6 6 6 6 6 6 6 6 6 6 6 6
6 6 8 11 12 6 6 8 6 6 6 6 6 58 59 61 6 6 6 55 56 6 6 6 6 6 6 6 6 6 6 6 6 6 6 6 6 6 6 6 6 6 6 6 6 6 6 6 6 6
6 6 6 6 6 6 6 6 6 6 6 6 58 59 61 6 6 6 6 6 6 6 6 6 6 6 6 6 6 6 6 6 6 6 6 6 6 6 6 6 6 6 6 6 6 6 6 6 6 6
6 6 6 6 6 8 6 6 6 6 6 58 57 61 6 6 6 6 6 6 8 6 6 6 6 6 6 6 6 6 6 6 6 6 6 6 6 6 6 6 6 6 6 6 6 6 6 6 6 6
6 6 6 6 6 6 6 6 6 6 58 57 61 6 8 6 6 6 8 6 6 6 6 6 6 6 6 6 6 6 6 6 6 6 6 6 6 6 6 6 6 6 6 6 6 6 6 6 6 6
6 6 6 6 58 59 58 59 58 59 57 61 6 6 6 6 6 6 6 10 9 6 6 8 6 6 6 6 6 6 6 6 6 6 6 6 6 6 6 6 6 6 6 6 6 6 6 6 6 6
6 8 6 58 57 61 60 61 60 61 61 6 6 6 6 6 6 6 6 11 12 6 6 6 6 6 6 6 6 6 6 6 6 6 6 6 6 6 6 6 6 6 6 6 6 6 6 6 6 6
6 6 58 57 61 6 6 6 6 6 6 6 6 6 6 58 59 6 6 6 6 6 6 6 6 6 6 6 6 6 6 6 6 6 6 6 6 6 6 6 6 6 6 6 6 6 6 6 6 6
6 6 60 61 6 6 6 6 10 9 6 6 6 6 58 57 57 59 6 6 6 6 8 6 6 6 6 6 6 6 6 6 6 6 6 6 6 6 6 6 6 6 6 6 6 6 6 6 6 6
6 6 58 59 6 8 6 6 11 12 6 6 6 58 57 61 60 57 59 6 6 6 6 6 6 6 6 6 6 6 6 6 6 6 6 6 6 6 6 6 6 6 6 6 6 6 6 6 6 6
6 6 60 61 6 6 6 6 6 6 6 6 58 57 61 6 6 60 57 59 6 6 6 6 6 6 6 6 6 6 6 6 6 6 6 6 6 6 6 6 6 6 6 6 6 6 6 6 6 6
6 6 58 59 6 6 6 6 6 6 6 58 57 61 6 6 6 6 60 57 59 6 6 6 6 6 6 6 6 6 6 6 6 6 6 6 6 6 6 6 6 6 6 6 6 6 6 6 6 6
6 6 60 57 59 6 6 6 54 53 6 6 6 6 6 6 6 6 58 57 61 6 6 6 6 6 6 6 6 6 6 6 6 6 6 6 6 6 6 6 6 6 6 6 6 6 6 6 6 6
6 6 6 60 57 59 6 6 55 56 6 6 6 6 6 6 6 58 57 61 6 6 6 6 6 6 6 6 6 6 6 6 6 6 6 6 6 6 6 6 6 6 6 6 6 6 6 6 6 6
6 6 6 6 60 57 59 6 6 6 6 6 6 6 6 6 58 57 61 6 6 6 6 6 6 6 6 6 6 6 6 6 6 6 6 6 6 6 6 6 6 6 6 6 6 6 6 6 6 6
6 6 6 6 6 60 57 59 58 59 58 59 58 59 58 59 57 61 6 6 6 6 6 6 6 6 6 6 6 6 6 6 6 6 6 6 6 6 6 6 6 6 6 6 6 6 6 6 6 6
6 6 54 53 6 6 60 61 60 61 60 61 60 61 60 61 61 6 6 6 6 6 6 6 6 6 6 6 6 6 6 6 6 6 6 6 6 6 6 6 6 6 6 6 6 6 6 6 6 6
6 6 55 56 6 6 6 6 6 6 6 6 6 6 6 6 6 6 8 6 6 6 6 6 6 6 6 6 6 6 6 6 6 6 6 6 6 6 6 6 6 6 6 6 6 6 6 6 6 6
6 6 6 6 6 6 6 6 6 6 8 54 53 6 6 6 6 6 6 6 6 6 6 6 6 6 6 6 6 6 6 6 6 6 6 6 6 6 6 6 6 6 6 6 6 6 6 6 6 6
6 6 6 6 6 6 6 6 6 6 8 55 56 6 6 6 6 6 6 6 6 6 6 6 6 6 6 6 6 6 6 6 6 6 6 6 6 6 6 6 6 6 6 6 6 6 6 6 6 6
6 6 6 6 6 6 10 9 6 6 6 6 6 6 6 6 54 53 6 6 6 6 6 6 6 6 6 6 6 6 6 6 6 6 6 6 6 6 6 6 6 6 6 6 6 6 6 6 6 6
59 6 6 6 6 6 11 12 6 6 6 6 6 6 6 6 55 56 6 6 6 6 6 6 58 6 6 6 6 6 6 6 6 6 6 6 6 6 6 6 6 6 6 6 6 6 6 6 6 6
57 59 6 6 8 6 6 6 6 6 6 6 6 6 6 6 6 6 6 6 8 6 6 58 57 6 6 6 6 6 6 6 6 6 6 6 6 6 6 6 6 6 6 6 6 6 6 6 6 6
60 57 59 6 6 6 6 6 6 6 6 6 6 6 6 6 6 6 6 6 6 6 58 57 61 6 6 6 6 6 6 6 6 6 6 6 6 6 6 6 6 6 6 6 6 6 6 6 6 6
6 60 57 59 58 59 58 59 58 59 58 59 58 59 58 59 58 59 58 59 58 58 57 61 61 6 6 6 6 6 6 6 6 6 6 6 6 6 6 6 6 6 6 6 6 6 6 6 6 6

