5 5 5 5 5 5 5 5 5 5 5 5 5 5 5 5 5 5 5 5 5 5 5 5 5 5 5 5 5 5 5 5 5 5 5 5 5 5 5 5 5 5 5 5 5 5 5 5 5 5
5 5 5 5 5 5 5 4 4 4 4 4 4 4 4 4 4 4 4 4 4 4 4 4 5 5 5 5 5 5 5 5 5 5 5 5 1 1 1 1 1 1 1 1 5 5 5 5 5 5
5 5 5 5 5 5 5 4 4 1 1 1 1 1 1 1 1 1 1 1 1 1 2 4 5 5 5 5 5 5 5 5 5 5 5 1 1 1 1 1 1 1 1 1 1 5 5 5 5 5
5 5 5 5 5 5 5 4 4 1 0 0 0 0 0 0 0 0 0 0 0 0 1 4 5 5 5 5 5 5 5 5 5 5 1 1 1 1 0 0 0 1 1 1 1 1 5 5 5 5
5 5 4 4 4 5 5 4 4 1 0 0 0 0 0 0 0 0 0 0 0 0 1 4 5 5 5 5 5 5 5 5 5 1 1 1 0 0 0 0 0 0 0 1 1 1 5 5 5 5
5 5 4 4 4 5 5 5 5 1 1 1 0 0 0 0 1 1 1 0 0 0 2 4 5 5 5 5 5 5 5 5 1 1 1 0 0 0 0 0 0 0 0 0 1 1 1 5 5 5
5 5 5 5 5 5 5 5 5 4 4 1 1 1 1 1 1 1 1 0 0 0 1 4 5 5 5 5 5 5 5 1 1 1 0 0 0 0 0 0 0 0 0 0 0 1 1 1 5 5
5 5 5 5 5 5 5 5 5 4 4 4 4 4 4 1 1 1 1 1 0 0 1 4 5 5 5 5 5 5 1 1 1 1 0 0 0 0 0 0 0 0 0 0 0 1 1 1 5 5
5 5 5 5 5 5 5 5 5 4 2 2 2 4 4 1 1 4 4 2 1 2 1 4 5 5 5 5 5 5 1 1 1 0 0 0 0 0 4 4 4 0 0 0 0 0 1 1 1 5
5 5 5 5 5 5 5 5 5 4 4 4 4 4 1 1 1 4 4 4 4 4 4 4 5 5 5 5 5 5 1 1 1 0 0 0 0 0 4 2 4 0 0 0 0 0 1 1 1 5
5 5 5 5 5 5 5 5 5 2 1 1 1 1 1 1 2 4 4 4 4 4 4 4 5 5 5 5 5 5 1 1 1 0 0 0 0 0 4 4 4 0 0 0 0 0 1 1 1 5
5 5 5 5 5 5 5 5 5 4 1 1 1 1 1 1 1 1 1 1 1 1 1 1 5 1 1 1 1 1 1 1 1 1 0 0 0 0 0 0 0 0 0 0 0 1 1 1 5 5
5 5 5 5 5 5 5 5 5 4 1 1 2 1 1 1 1 1 1 1 1 1 1 1 1 1 1 1 1 1 1 1 1 1 0 0 0 0 0 0 0 0 0 0 0 1 1 1 5 5
5 5 5 5 5 5 5 5 5 4 1 1 1 1 1 1 1 1 1 1 1 1 1 1 5 1 1 1 1 1 1 1 1 1 1 0 0 0 0 0 0 0 0 0 1 1 1 5 5 5
5 5 5 5 5 5 5 5 5 2 1 1 1 1 1 2 4 4 4 4 4 4 4 4 5 5 5 5 5 5 5 5 5 1 1 1 0 0 0 0 0 0 0 1 1 1 5 5 5 5
5 5 5 5 5 5 5 5 5 5 4 1 1 1 1 4 4 4 4 4 4 4 4 4 5 5 5 5 5 5 5 5 5 5 1 1 1 1 0 0 0 1 1 1 1 5 5 5 5 5
5 5 5 5 5 5 5 5 5 5 4 1 1 1 1 2 4 4 4 4 4 4 4 4 5 5 5 5 5 5 5 5 5 5 5 1 1 1 1 1 1 1 1 1 5 5 5 5 5 5
5 5 5 5 5 5 5 5 5 5 2 1 1 1 4 4 4 4 5 5 5 5 5 5 5 5 5 5 5 5 5 5 5 5 5 5 1 1 1 1 1 1 1 1 5 5 5 5 5 5
5 5 5 5 5 5 5 5 5 5 4 1 1 1 4 5 5 5 5 5 5 5 5 5 4 5 5 5 5 5 5 5 5 5 5 5 5 5 1 1 1 1 1 5 5 5 5 5 5 5
5 5 5 5 5 5 5 5 5 5 4 1 1 1 4 5 5 5 5 5 5 5 5 5 5 5 5 5 5 5 5 5 5 5 5 5 5 5 5 1 1 1 5 5 5 5 5 5 5 5
5 5 2 2 2 5 5 5 5 5 4 1 1 1 4 5 5 5 5 5 5 5 5 5 5 5 5 5 5 5 5 5 5 5 5 5 5 5 5 1 1 1 5 5 5 5 5 5 5 5
5 5 2 2 2 5 5 5 5 5 4 1 1 1 4 2 5 2 2 5 5 5 5 5 5 5 5 5 5 5 5 5 5 5 5 5 5 5 5 1 1 1 5 5 5 5 5 5 5 5
5 5 5 5 5 5 5 5 5 5 2 1 1 1 4 5 5 2 5 5 5 5 5 5 5 5 5 5 5 5 5 5 5 5 5 5 5 5 5 1 1 1 5 5 5 5 5 5 5 5
5 5 5 5 5 5 5 5 5 5 4 1 1 1 4 5 5 5 5 5 5 5 5 5 5 5 5 5 5 5 5 5 5 5 5 5 5 5 5 1 1 1 5 5 5 5 5 5 5 5
5 5 5 5 5 5 5 5 5 5 4 5 1 5 4 5 5 5 5 5 5 5 5 5 5 5 5 5 5 5 5 5 5 5 5 5 5 5 5 1 1 1 5 5 5 5 5 5 5 5
6 6 6 6 6 6 6 6 6 6 6 6 1 6 6 6 6 6 6 6 6 6 6 6 6 6 6 6 6 6 6 6 6 6 6 6 6 6 6 6 1 6 6 6 6 6 6 6 6 6
6 6 6 6 6 6 6 6 6 6 6 6 1 6 6 6 6 6 6 6 6 6 6 6 6 6 6 6 6 6 6 6 6 6 6 6 6 6 6 6 1 1 6 6 6 6 6 6 6 6
6 6 6 6 6 6 6 6 6 6 6 6 1 6 6 6 6 6 6 6 6 6 6 6 6 6 6 6 6 6 6 6 6 6 6 6 6 6 6 6 6 1 6 6 6 6 6 6 6 6
6 6 6 6 6 6 8 6 6 6 6 6 1 6 6 6 8 6 6 6 6 6 6 6 6 6 6 6 6 6 6 6 6 6 6 6 6 6 6 6 6 1 1 6 6 6 6 6 6 6
6 6 6 6 6 6 6 6 6 6 6 6 1 6 6 6 6 6 6 6 6 6 6 6 6 6 6 6 6 6 6 1 1 1 1 1 1 1 6 6 6 6 1 1 6 6 6 6 6 6
6 6 6 6 6 6 6 6 6 6 8 6 1 6 6 6 8 6 6 6 6 6 6 6 6 6 6 6 6 6 1 1 6 6 6 6 6 1 1 1 6 6 6 1 1 6 6 6 6 6
6 6 6 6 6 6 6 6 6 6 6 6 1 6 6 6 6 6 6 6 6 6 6 6 6 6 6 6 6 1 1 6 6 6 6 6 6 6 6 1 1 1 6 6 1 1 6 6 6 6
6 6 6 6 6 6 6 6 6 6 6 6 1 6 6 6 6 10 13 9 6 6 6 6 6 6 6 6 1 1 6 6 6 6 6 1 1 1 1 6 6 1 1 6 6 1 6 6 6 6
6 6 6 6 8 6 6 6 6 6 6 6 1 6 6 6 6 13 13 13 6 6 6 6 6 6 6 6 1 6 6 6 6 1 1 1 7 7 1 1 6 6 1 1 6 1 1 6 6 6
6 6 6 6 6 6 6 8 6 6 6 6 1 6 6 6 6 11 13 12 6 6 6 6 6 6 6 1 1 6 6 1 1 1 7 7 7 7 7 1 1 1 6 1 6 6 1 1 6 6
6 6 6 6 6 6 6 6 6 6 6 6 1 6 6 6 6 6 6 6 6 6 6 6 6 6 6 1 6 6 6 1 7 7 7 7 1 1 7 7 7 1 6 1 6 6 6 1 6 6
6 6 6 6 6 6 6 6 6 6 6 6 1 6 6 6 6 6 6 6 6 6 6 6 6 6 6 1 6 6 6 1 1 7 7 7 1 1 7 7 7 1 6 1 1 6 6 1 6 6
6 6 6 6 6 6 6 6 6 6 6 6 1 6 6 6 6 6 6 6 6 6 6 6 6 6 6 1 1 6 6 6 1 7 7 7 7 1 1 7 1 1 6 6 1 6 6 1 6 6
6 6 6 6 6 6 6 6 6 6 6 3 1 3 6 6 6 6 6 6 6 6 6 6 6 6 6 6 1 6 6 6 1 1 1 7 7 7 1 1 1 6 6 1 1 6 1 1 6 6
6 6 6 6 10 9 6 6 6 6 6 3 1 3 6 6 6 6 6 6 6 6 6 6 6 6 6 6 1 1 1 6 6 6 1 1 1 6 6 6 6 6 6 1 6 1 1 6 6 6
6 6 6 6 11 12 6 6 6 6 6 3 3 3 6 6 6 6 6 6 6 6 6 6 6 6 6 6 6 6 1 1 1 6 6 6 1 1 6 6 6 6 1 1 6 1 6 6 6 6
6 6 6 6 6 6 6 6 6 6 6 6 6 6 6 6 6 6 6 6 6 6 6 6 6 6 6 6 6 6 6 6 1 1 6 6 6 1 1 6 6 1 1 6 1 1 6 6 6 6
6 6 6 6 6 6 6 6 6 6 6 6 6 6 6 6 6 6 6 6 6 6 6 6 6 6 6 6 6 6 6 6 6 1 1 6 6 6 1 1 1 1 6 6 1 6 6 6 6 6
6 6 6 6 6 6 6 6 6 6 6 6 6 6 6 6 6 6 6 6 6 6 6 6 6 6 6 6 6 6 6 6 6 6 1 1 1 6 6 6 6 6 1 1 1 6 6 6 6 6
6 6 6 6 6 6 6 6 6 6 6 6 6 6 6 6 6 6 6 6 6 6 6 6 6 6 6 6 6 6 6 6 6 6 6 6 1 1 6 6 6 6 1 6 6 6 6 6 6 6
6 6 6 6 6 6 6 6 6 6 6 6 6 6 6 6 6 6 6 6 6 6 6 6 6 6 6 6 6 6 6 6 6 6 6 6 6 1 1 6 6 1 1 6 6 6 6 6 6 6
6 6 6 6 6 6 6 6 6 6 6 6 6 6 6 6 6 6 6 6 6 6 6 6 6 6 6 6 6 6 6 6 6 6 6 6 6 6 1 1 1 1 6 6 6 6 6 6 6 6
6 6 6 6 6 6 6 6 6 6 6 6 6 6 6 6 6 6 6 6 6 6 6 6 6 6 6 6 6 6 6 6 6 6 6 6 6 6 6 6 6 6 6 6 6 6 6 6 6 6
6 6 6 6 6 6 6 6 6 6 6 6 6 6 6 6 6 6 6 6 6 6 6 6 6 6 6 6 6 6 6 6 6 6 6 6 6 6 6 6 6 6 6 6 6 6 6 6 6 6
6 6 6 6 6 6 6 6 6 6 6 6 6 6 6 6 6 6 6 6 6 6 6 6 6 6 6 6 6 6 6 6 6 6 6 6 6 6 6 6 6 6 6 6 6 6 6 6 6 6







